* ****************
*   * * ******** *
* *****     **** *
* *     *** **** *
* * *** *** ****  
*   *   *        *
***** * * ****** *
*     * *   **** *
******* **********
